0000101001110101
1011111011111100
1000001110100001
1101010000101010
1011011100001010
0110000000101111
1100101000001101
0100010001111111
1110111000100010
0011110000010100
1010000010011000
0000010000101000
0100010100111011
1001000001100111
1100011111100010
0110000000000000
