0001000001001011
0001010000101111
0000001011111110
0010110011101111
1010010100111100
0100100101101011
1001000000001111
1010100001111111
1110010011111001
1111011000001000
1100001110000100
1000000100010000
0001001010111110
1011000110011000
1111001100000100
0100100011000010
