0001101000011000
1000000110110110
1101110111110101
1000001001101110
0101101101100100
0010101110010101
0100010000010111
1100000011001000
1101100100101011
1010000100010110
0110000100001101
1101010100111011
1111100011011000
1101100111001111
0010010011101111
1111000011001000
