0000100011110100
0101010010000100
1110010010100001
0110011010000000
0010001111010110
0111100110111011
0001010000010011
0010110001101101
1111101111010011
1100001001100110
0000000000010001
1001100100111011
0000011101101110
0010101010010010
0010100011001000
0110101111101000
